{
    "sprite_size": 16,
    "sprite_sheet": "forest.png",
    "sprite_sheet_cols": 16,
    "sprite_sheet_rows": 16,
    "width": 16,
    "height": 12,
    "map": [
        81,81,81,81,81,81,81,81,81,81,81,81,81,81,81,81,
        17,17,81,81,17,17,17,17,81,81,17,17,17,17,17,81,
        81,17,81,81,17,81,81,17,81,81,17,17,17,17,17,81,
        81,17,81,81,17,81,81,17,81,81,17,17,17,17,17,81,
        81,17,81,81,17,81,81,17,81,81,17,17,17,17,17,81,
        81,17,81,81,17,81,81,17,81,81,17,17,17,17,17,81,
        81,17,81,81,17,81,81,17,81,81,81,81,17,81,81,81,
        81,17,81,81,17,81,81,17,81,81,81,81,17,81,81,81,
        81,17,81,81,17,81,81,17,81,81,81,81,17,81,81,81,
        81,17,81,81,17,81,81,17,81,81,81,81,17,81,81,81,
        81,17,17,17,17,81,81,17,17,17,17,17,17,81,81,81,
        81,81,81,81,81,81,81,81,81,81,81,81,81,81,81,81
    ]
}